00000000000000000000000000
00000000000000000000000000
00000000110011000000000000
00000000110011000000000000
44000044114411440000440000
44000044114411440000440000
11444411111111114444114400
11444411111111114444114400
11111111221122111111114400
11111111221122111111114400
33333311111111113333334400
33333311111111113333334400
33111111111111111111333344
33111111111111111111333344
11111133111111331111114444
11111133111111331111114444
11113333331133333311113333
11113333331133333311113333
44333344444444443333443344
44333344444444443333443344
00444400000000004444004400
00444400000000004444004400
00000000000000000000000000
00000000000111100000000000
00000000000166100000000000
00000000000166100000000000