00000000000000000000000000
00000011111100001100000000
00001111111111111111000000
00111111111111111111000000
00444444444444444411110000
00444444444444444411110000
44440000000000004444111100
44440000000000004444111100
44002200002200000044444400
44002200002200000044444400
44002200002200000044444400
44002200002200000044444400
44000044000000004444111110
44000044000000004444111110
44444444444444444411111110
44444444444444444411111110
11444411114444441111111100
11444411114444441111111100
00111111111111111111110022
00111111111111111111110022
22001122111111111111100022
22001122111111111111100022
00221111220000001111222222
00221100220111101111222222
00000000000166100000000000
00000000000166100000000000
