55555555555500555555555555
55555555555500555555555555
55555555555555555555555555
55555555555555555555555555
55555511555555555511555555
55555511555555555511555555
55110011001155110011001155
55110011001155110011001155
55111111000000000011111155
55000011000000000011000055
55555511001122110011555555
55555511111122111111555555
22555555002200220055555522
22555555000000000055555522
55555555000000000055555555
55555555001100110055555555
55555555001100110055555555
55555555001100110055555555
55555511000000000011555555
55555511000011000011555555
55115511002222220011551155
55115511000000000011551155
00110011000000000011001100
00111111000111100011111100
00110000000166100011001100
00000000000166100000000000
