00003333000000000000000000
00003333000000000000000000
00000033440010000000000000
22000033440010000000000000
44000000000020001000333300
44220000000020001000333300
44440022000100002044330000
44440000110100002044330000
44444400002200010000000000
44444400002211010000000022
44442200000100220000000044
44440022000100221100002244
44220000112200010022004444
44000000002200010000004444
00000000001011220000444444
00000000001000220000444444
00003344020000101100224444
00003344020000100022004444
00333300010002000000000044
00333300010002000000000044
00000000000001004433000022
00000000000001004433000000
22000000000000000033330000
22000000000111100033330000
22220000000166100000000022
22220000000166100000000022