00000022000000220000000000
00000022000000220000000000
00110022000000110011001100
00110022000000110011001100
00110000000011110011221100
00110000000011110011221100
00000011000000000022000000
00000011000000000022000000
44000011000022000011441122
44000011000022000011441122
44440000001100002200440000
44440000001100002200440000
00111111444444220000441100
00111111444444220000441100
00000022441100110011001100
00000022441100110011001100
22110022001100110000001100
22110022001100110000001100
00110011001111110011221100
00110011001111110011221100
00110011001111110000000000
00110011001111110000000000
00110000000000000011001100
00110000000111100011001100
00110011000166100011111100
00110011000166100011111100