00000033001100001100110000
00000033001100001100110000
00000000000000001100220000
00000000000000001100220000
00000033000022001100110000
00000033001122001100110000
22001133002200001100110000
00001133002200110000110000
00001133000000110000000000
00001133000000110000000000
11001133330033333333000011
11001133330033333333000011
00000000000000440033002222
00000011000000440033000000
11110111002244444433000000
11110111002244444433111111
11000100001144444433110000
00000100001144444433110000
00000000001100440033004400
00220000001100440033004400
00110000001111110000444444
00110022000000000000444444
00110011000000000033444444
00110011000111100033444444
00000000000166100033004400
00000000000166100033004400