00000000220000000000000000
00000000220000000000000000
22220000220000222200000000
22220000220000222200000000
00220000220000002200222244
00220000220000002200222244
00220000222222004400220000
00220000222222004400220000
00110000000022002222220000
00110000000022002222220000
44222200221122111100000000
44222200221122111100000000
00002244224400001100002222
00002244224400001100002222
00002200004400002200002200
00002200004400002200002200
00001100002200002222112200
00001100002200002222112200
44222222444411222200112200
44222222444411222200112200
00000011000000004444001100
00000011000000004444001100
00000022000000000044001100
00000022000111100044001100
00000022000166100022001100
00000022000166100022001100