00000033000000003300000000
00000033000000003300000000
33330033003333333300333333
33330033003333333300333333
44441100001100003300334433
44441100001100003300334433
44333333330022000011444444
44333333330022000011444444
44440033000033003333333344
44440033000033003333333344
33330033003333000033000000
33330033003333000033000000
00001144110011440033000033
00001144110011440033000033
00333344333333330044110033
00333344333333330044110033
11000011000033004444330033
11000011000033004444330033
33330033330033113333330000
33330033330033113333330000
00001100444400004433000033
00001100444400004433000033
00333333440000000033003333
00333333440111100033003333
00330000000166100000000000
00330000000166100000000000