00110011001100110011001100
00110011001100110011001100
00110011001100110011001100
00110011001100110011001100
00220022002200220022002200
00000000000000000000000000
00000000110000001100000000
11001100110000001100110011
11001111110011001111110011
11001100110011001100110011
22002200220022002200220022
00000000220000002200000000
44440000110044001100004444
44440000110044001100004444
44444444111144111144444444
44444444110044001144444444
44444444444444444444444444
44444444444444444444444444
00000000114444441100000000
11001100114444441100110011
00110011000044000011001100
00110011000044000011001100
00110011000000000011001100
00110011000111100011001100
00110011000166100011001100
00000000000166100000000000