00000000111100001100000000
00000000111100001100000000
00444411110000001100000000
00444411110000001100000000
44444444444444441111000000
44444444444444441111000000
44221144111111444444441122
44001144111111444444441122
44441144444422444411201100
44441144444400444411201100
00444411004444444411001100
00444411224444444411001100
00111111111144441111104444
00111111111144441111104444
02221111000000111100000044
02001111000000110000000044
00110011000000114444111044
00110011002211004444111044
00110000011111444411000044
00110000011100444411000044
00111110011144440044114444
00111110010044441144114444
00001100440000001144114400
00001100440111101144004400
00001100000166100044444400
00000000000166100044444400