00000000004400000000000000
00000000004400000000000000
00000000442244000000000000
00000000442244000000000000
00004400004400004444000000
00004400004400004444000000
00441144000000441111440000
00441144000000441111440000
00004411440000004444000044
00004411440000004444000044
44000044000044000000004422
44000044000044000000004422
11440000004422440000440044
11440000004422440000440044
22114400000044000044224400
22114400000044000044224400
11440000440000004400440000
11440000440000004400440000
44000044114400441144000000
44000044114400441144000000
00000044114400004400004400
00000044114400004400004400
00440000440000000000442244
00440000440111100000442244
44224400000166100044114400
44224400000166100044114400