00000000000000000000000000
00000000000000000000000000
44440000001111110000004444
44440000111111111100004444
44000001111111111110000044
44000001111111111110000044
00000011114411441111000000
00000011114411441111000000
00000011444411444411000000
00000011444411444411000000
44000011111111111111000044
44000011111111111111000044
44440000114411441100004444
44440000114411441100004444
33333300111111111100333333
33333300111111111100333333
00000000010101010100000000
00000000010101010100000000
00000000101010101000000000
00000000101010101000000000
02020200000000000000202020
02020200000000000000202020
10101000000000000000010101
10101000000111100000010101
20202002000166100020020202
20202002000166100020020202