00000000000000000000110000
00000000000000000000110000
00113333002200110000000000
00113333002200110000000000
00003333114444443333002200
00003333114444443333002200
00000000004444443333110000
00000000004444443333110000
00220000333300440000000000
00220000333300440000000000
44441100333322000000001100
44441100333322000000001100
44444400000000000022000022
44444400000000000022000022
00113333001100000000000000
00113333001100000000000000
22003333444433334444001100
22003333444433334444001100
00000000440033334444333300
00000000440033334444333300
00000022440000004444333300
00000022440000004444333300
00001100110000000000000000
00001100110111100000000000
11000000000166100011220000
11000000000166100011220000
