00000000110000001100000000
00000000110000001100000000
00444444110000000000000000
00444444110000000000222222
11444444000000000000000000
11444444000000000000000000
44444444000000110011111110
44444444000000110011111110
44444444111111110011000100
44444444111111000011000100
44444444000011000000000100
44444444000011000000000100
00440000000022222200004400
00440000000022222200004400
00000000000000000044444444
00110011000000000044444444
11100111100111111144444444
11100111100100000044444444
00000000001100000044444444
00000000001100111144444444
11000020000000111144444400
11000020000000000044444400
11110020000000000044444400
11110020000111100044444400
22111100000166100011000000
22111100000166100011000000
