00000000000000002222224400
00000000000000002222224400
00110000000000002200002200
00110000000000002200002200
11441100000011111111002200
11441100000011111111002200
00114411000011004411222200
00114411000011004411222200
00001100442211440011000000
00001100442211440011000000
00000000220011221111000000
00000000220011221111000000
00001111221100220000000000
00001111221100220000000000
00001100441122440000000000
00001100441122440000000000
22222244001100001111000000
22222244001100001111000000
22001111111100001122220000
22001111111100001122220000
22000022000000000022111100
22000022000000000022111100
44222222000000000000112222
44222222000111100000112222
00000000000166100000002222
00000000000166100000002222