00002200112200000000010000
00002200110000000000010000
00001100114400111111110000
00001100114400001111110000
00444400114401100000002222
00444400114401100000002222
44444444444411111100011100
44444444444411111100011100
00004444000022110001111101
00004444111100110001110001
11220000111100000011000001
11000011000000000011000001
01000011555555555555555555
01001111555555555555555555
01001100555555555555555555
01000000555555555555555555
00002200555555555555555555
00002200555555555555555555
11001100555555555555555555
11001100555555555555555555
01001100555555555555555555
01001100555555555555555555
01001100000000005555555555
01001100000111105555555555
00001100000166100055555555
00000000000166100055555555