00000000000000000000022000
00000000000000000000022000
00000000000000000000220000
00000000000022000000220000
00000000000044000011100000
00000000001144110011100000
00000000004444440011100000
00000000224444442211100000
00000000444455444411100000
00000011444455444411100000
00000044445555554444100000
00002244445555554444100000
00004444555555555544440000
00114444555555555544441100
00444455555555555555444400
22444455555555555555444422
44445555555555555555554444
44445555555555555555554444
00445555555555555555554400
00445555555555555555554400
00445555555555555555554400
00445555555555555555554400
00445555550000005555554400
00445555550111105555554400
00445555000166100055554400
00445555000166100055554400
