00000000220000000022000000
00000000220000000022000000
00220000002200002244440000
00220000002200002244440000
00002200000000224400200000
00002200000000224422200000
00000022004444444444000200
00000022004444444444000200
00200000224444224400002200
00200000224444224400002200
00222044002244442200000200
00002044002244442200000200
00004444444444000022000000
00004444444444000022000000
00002044002244000000220000
00222044002244000000220000
00444444220022000000002200
00444444220022002200002200
44444422000000000200000000
44444422000000000200000000
00002200000000000000000222
00002200000000000000000222
00000000000000000000200000
00000000000111100022200000
20000000000166100000000000
20002200000166100000000000