00000011000000000000440000
00000011000000000022440000
11000000000000440222200011
11000000000022440222200011
00000000440222200022440000
00000022440222200000440000
00000222200022440000000000
00000222200000440000000000
00000022440000000000000000
00000000440000000000000000
00000044004400440044000000
00000044224400442244000000
22110002222000022220001122
22110002222000022220001122
00000044224400442244000000
00000044004400440044000000
00000000000000000000000000
00000000220000000022000000
11000002222000000222200011
11000002222000000222200011
11000044224400004422440011
11000044004400004400440011
00000000000000000000000000
00001100000111100000110000
00001111000166100011110000
00001111000166100011110000