00000000000000000000000000
00000000110000000000110000
00110011110000555555111100
00110011110000555555111100
00110000110022555555555500
00110000110022555555555500
55555520110000115555555500
55555520110000115555555500
55555555555511110110000000
55555555555511110110000000
00000255555555110110002222
00000255555555110110000000
11111111555555555555551111
11111111555555555555551111
00000011115555555520000000
00000011115555555520000000
00111111005555551111001100
00111111005555551111001100
55555511550000000011001100
55555511550000000011001100
55555555552200220000001100
55555555550000000000111100
11555555550000000011000000
11555555550111100011000000
11112000000166100011001100
11112000000166100011001100