00000000002200110011110000
00000000002200110011110000
00011111111100110000000000
00011111111100110000000000
00000010001100111100444444
00000010001100111100444444
00010000000000220044444444
00010000000000220044444444
00010011111122111144441122
00010011111122111144440022
00111111220000110044440001
00000000220000110044440001
01111111002244444444440000
01111111002244444444440000
00000022000044444444441100
00000022000044444444441100
22110044444444224444441100
22110044444444224444441100
01114444444444000000001110
01114444444444000000001110
00114444000000002211111100
00114444000000000011111100
00004444000000000011000100
00004444000111100011000100
00004444000166100000000000
00114444000166100000000000