00000000000000000000000000
00000000000000000000000000
00002244220000000000000000
00002244220000000000000000
00000044004400000000000000
00000044004422000000000000
00440000000044000000000000
00440000000044110000000000
00444400004400440000000000
00444400004400442200000000
00440044004400004400000000
00440044004400004411000000
00440000440000004444000000
00440000440000004444220000
00004400000000444444440000
00004400000000444444441100
00000044000044004444444400
00000044000044004444444400
11000000000044000044444422
11000000000044000044444422
11110000000000440044444444
11110000000000440044444444
22111100000000004400444444
22111100000111104400444444
22221111000166104400004444
22221111000166104400004444