00000000111100000000000000
00000000111100000000000000
00000000110000002222220000
22001100110000000000220000
22001100000011000000000000
22001100000011000000000000
11001111110011110033330033
11001111110011110033330033
11000000110000000033000000
00000000000000000033000000
00000000333300333333001111
00001100333300333333001111
11110000331100111000000000
11110000331100111000000000
00000000330000000000022000
00000000330000000000022000
33333300330022001100020000
33333300330022001100020000
00000000000000000000021111
00000011110000000000021111
00000000111111111100000000
00000000110000001111000000
11111100000000000011110000
11110000000111100000110000
11000000000166100000000000
00000000000166100000000000