00000000000000000000000000
00000000000000000000000000
00000000000000000000000000
00000000001111000000220000
00000000004444000000440000
00222200114444220011441100
00444400444444440044444400
11444411444444441144444411
44444444444444444444444444
44444444444444444444444444
22443344444444443344444444
22443344444444443344444444
44443333334444443333334422
44443333334444443333334422
44444444334422444444334444
44444444334422444444334444
44444444444444444444444444
44444444444444444444444444
44444444441111444444444422
44444444440000444444444400
22444444110000114444442200
00444444000000004444440000
00221111000000001111110000
00000000000111100000000000
00000000000166100000000000
00000000000166100000000000