00000000000000000000000000
00000000000000000000000000
00000000002222000000000000
00000000002222000000000000
00000000000022000000000000
00000000000022000000000000
00222244441122114444222200
00222244441122114444222200
00000022444422444422000000
00000022444422444422000000
44000000224444442200000044
44000000224444442200000044
22440000004444440000004422
22440000004444440000004422
44000000002244220000000044
44000000220044002200000044
00000000220000002200000000
00000000220022002200000000
00000022000022000022000000
00000022000022000022000000
00000000000000000000000000
00000000000000000000000000
00000000000000000000000000
00000000000111100000000000
00002200000166100000220000
00002200000166100000220000
