00000000000000000000000000
00000000000000000000000000
00011111000000000000111110
00010011000000000000110010
01110000110044440011000001
01000000110044440011000001
11000000114444444411000001
11000000114444444411000001
11000001114422224411100011
11000001114422224411100011
01000011333333333333111111
01111111333333333333111111
00111111222211222211111110
00111111222211222211111110
00001111220011002211110000
00001111220011002211110000
00001111111111111111110000
00001111111111111111110000
11441111112222111111114411
11440000002222000000004411
11444444444444444444444411
11444444444444444444444411
00004444440000004444444400
00004444440111104444444400
00000010000166100000100000
00000010000166100000100000