00001100001100000011000000
00001100001100110011000000
44111111001100000011100000
44111111001100220011100000
44444400001100110011000110
44444400000000110000000110
44333333333333333333330033
44333333333333333333330033
00110000000000000000000000
00110000000011110000000000
00001100000111111111112222
00001100000111110011000000
11110011000111114411000011
11110011000111114411222211
00000022000000444444440000
00000022002200444444440000
33330033333333330033333333
33330033333333330033333333
44440001000000000000000000
44440001000011110000000000
44441100100000010000001100
44441100100000010022111100
44001100100000000011001100
44221100100111100000001100
00000000000166100000001100
00000000000166100011000000