00000000000000000000000000
00000000110000001100000000
00111111110000001111111100
00111111110000001111111100
00110000000011000000002200
00110000000011000000002200
00220011110000001111001111
00220011000000000011001111
00110010440022004401002211
00110010442222224401002211
00110000444444444400002211
00000000444444444400000011
11000000444444444400000011
11220000444444444400001111
11220010442222224401001100
11220010440022004401001100
11110011000000000011002200
11110011110000001111002200
11220000000011000000001100
11220000000011000000001100
11111111110000001111112222
11111111110000001111112222
11110000110000001100001100
11110000000111100000001100
11110000000166100000000000
11110000000166100000000000